 ####################################################################################################
 #                    P             P           P             #                                     #
 #                                                                                                  #
 #                                                                                                  #
 #           ###             ###     ###       ####      ###                                        #
 #                 ###                         ####                                                 #
 # S  ##           ###   ##                    ####      ###                                        #
 ########################################  ##########################################################
 ####################################################################################################
#####################################################################################################